*************
*************
*************
*************
**x*x*x*x*x**
**x*x*x*x*x**
**x*x*x*xgg**
**x*x*x*x*x**
**x*x*xrrrr**
**x*x*x*x*x**
**x*xbbbbbb**
**x*x*x*x*x**
**xpppppppp**
**x*x*x*x*x**
**yyyyyyyyy**
**sssssssss**
*************
*************
*************
*************
*************
*************
*************
*************
*************