*************
*************
*************
*************
xxxxxxxxxxxxx
****x****xp*
*xw*x*****x**
*x**x**x**x**
*x**xg*x**x**
*x**x**x**x**
*x*ox**x**x**
*x**x**x*bx**
*x**x**x**x**
*x**x*rx**x**
*x**x**x**x**
*xt***x***y
*xxxxxxxxxxxx
*************
*************
*************
*************
*************
*************
*************