*************
*************
*************
******x******
****ww*ww****
**ww**x**ww**
ww**oo*oo**ww
**oo**x**oo**
oo**yy*yy**oo
**yy**x**yy**
yy**gg*gg**yy
**gg**x**gg**
gg**rr*rr**gg
**rr**x**rr**
rr**bb*bb**rr
**bb*****bb**
bb*********bb
*************
*************
*************
*************
*************
*************
*************