*************
*************
*************
*************
******s******
***bbbsggg***
**bbbwwwggg**
**bbwwwwwgg**
*bbbwwwwwggg*
*bbbwwwwwggg*
*bbbwwwwwggg*
*s**s*s*s**w*
******s******
******s******
******s******
****y*y******
****yyy******
*****y*******
*************
*************
*************
*************
*************
*************
*************