*************
*************
*************
*************
xwoxtxgrxbx
xpsxssxsysxyx
*************
xpx*x*x*x*x*x
x*xp*x*x*x*x
x*x*xp*x*x*x
x*x*x*xp*x*x
x*x*x*x*xpx*x
************p
**x*x*x*xpx**
**x*x*xpx*x**
**x*xpx*x*x**
***px*x*x***
*p***x*****
*************
*************
*************
*************
*************
*************
*************