*************
*************
*************
*************
ttttttttttttt
*************
**sss*sss*sss
**sgs*sgs*sgs
**sss*sss*sss
*************
*sss*sss*sss*
*srs*srs*srs*
*sss*sss*sss*
*************
sss*sss*sss**
sbs*sbs*sbs**
sss*sss*sss**
*************
*************
*************
*************
*************
*************
*************
*************