*x***********
*************
*x***********
*x***********
*x*****b*****
*x****btb****
*x***btwtb***
*x**btwtwtb**
*x*btwtstwtb*
*x**btwtwtb**
*x***btwtb***
*x****btb****
*x*****b*****
*x***********
*x***********
*x***********
*xxxxxxxxxxxx
*************
*************
*************
*************
*************
*************
*************
*************