*************
*************
*************
*************
*sssssssssss*
*s*********s*
*s*sssssss*s*
*s*s*****s*s*
*s*s*sss*s*s*
*s*s*s*s*s*s*
*s*s*sss*s*s*
*s*s*****s*s*
*s*sssssss*s*
*s*********s*
*sssssssssss*
*************
*************
*************
*************
*************
*************
*************
*************
*************
*************