*************
*************
*************
*************
***x*x*x*x***
*x*********x*
*xx*x***x*xx*
******w******
*x***xox***x*
***x**t**x***
******g******
***x**r**x***
*x***xbx***x*
******p******
*xx*x***x*xx*
*x*********x*
***x*x*x*x***
*************
*************
*************
*************
*************
*************
*************
*************