*************
*************
*************
*************
b*r*g*t*g*r*b
b*r*g*t*g*r*b
b*r*g*t*g*r*b
b*r*g*t*g*r*b
b*r*g*t*g*r*b
b*xoxoxoxox*b
b*r*g*t*g*r*b
b*r*g*t*g*r*b
b*r*g*t*g*r*b
b*r*g*t*g*r*b
o*o*o*o*o*o*o
b*r*g*t*g*r*b
*************
*************
*************
*************
*************
*************
*************
*************
*************
