*************
*************
*************
*************
o*xyyyyyyyyx*o
o*xxyyyyyxx*o
o*x*xyyyx*x*o
o*x*pxyxt*x*o
o*x*p*s*t*x*o
o*x*p*g*t*x*o
o*x*p*g*t*x*o
o*x*p*g*t*x*o
o*x*p*g*t*x*o
oxxxp*g*txxxo
*************
*************
*************
*************
*************
*************
*************
*************
*************
*************
*************