*************
*************
*x*x*****x*x*
*xgx*****xgx*
*xtx*****xtx*
*xxx*****xxx*
*************
****pwwwy****
****poooy****
****pttty****
****pgggy****
****prrry****
****pbbby****
*************
*************
*************
*************
*************
*************
*************
*************
*************
*************
*************
*************