*************
*************
*************
*************
**xsss******
*x*****x*****
x**ttt**x****
x*ggggg*x****
x*bbbbb*x****
x**ppp**x****
*x*****x*****
**xxxxx******
*************
*************
*************
*************
*************
*************
*************
*************
*************
*************
*************
*************
*************