*************
*************
***y***y***
***y***y***
****y***y****
****y***y****
***sssssss***
***sssssss***
**ssrssr**
**ssrssr**
*sssssssssss*
*sssssssssss*
*sssssssssss*
*sssssssssss*
*s*s*****s*s*
*s*s*****s*s*
****ss*ss****
****ss*ss****
*************
*************
*************
*************
*************
*************
*************