*************
*************
*************
*************
*yyy*www*yyy*
*ppp*ooo*ppp*
*bbb*ttt*bbb*
*rrr*ggg*rrr*
*ggg*rrr*ggg*
*ttt*bbb*ttt*
*ooo*ppp*ooo*
*www*yyy*www*
*************
*************
*************
*************
*************
*************
*************
*************
*************
*************
*************
*************
*************